#########################
*************************
************************#
************************#
####********************#
************************#
*************************
*************************
*************************
****************#########
*************************
*************************
#************************
#************************
#************************
#************************
*************************
*************************
********##########*******
*************************
*************************
*************************
*************************
*************************
#########################